0 0 0 0 0 0 0 0 0 0 1 1 1 0 0 0 0 0 0 0
0 0 0 0 0 0 0 2 4 2 1 1 0 0 0 0 0 0 0 0
0 0 0 0 0 2 3 6 6 8 6 2 2 1 1 0 0 0 0 0
0 0 0 0 1 0 12 26 18 34 13 10 5 3 2 2 0 0 0 0
0 0 0 0 4 7 16 37 49 51 33 13 15 9 4 2 1 1 0 0
0 0 1 1 6 14 34 60 89 87 68 44 28 23 14 7 2 1 1 0
2 4 3 1 5 26 43 88 102 105 95 74 37 44 16 10 11 4 1 2
2 1 4 6 16 23 48 73 97 103 112 82 46 45 28 15 12 3 1 1
1 1 5 8 9 22 41 60 94 75 108 81 63 63 33 14 11 3 3 0
0 1 0 4 12 15 28 42 60 78 68 61 67 49 34 15 3 3 1 0
0 1 1 3 5 10 15 28 47 55 62 72 63 58 32 10 2 4 3 0
1 1 2 5 8 13 15 27 23 58 75 74 62 59 33 20 4 0 1 0
0 0 0 4 6 8 12 22 27 39 42 67 70 54 32 12 1 1 2 0
0 0 0 2 5 4 8 24 23 22 38 34 31 19 11 12 1 2 0 0
0 0 1 2 8 12 12 8 11 13 14 10 18 8 5 1 1 0 0 0
1 1 1 0 2 4 9 9 6 12 9 8 4 5 2 0 1 0 0 0
1 0 0 0 1 0 3 2 6 8 7 2 4 1 2 0 0 0 0 0
0 0 0 0 0 0 2 3 2 3 4 4 1 1 1 1 0 0 0 0
0 0 1 0 0 2 1 2 4 2 3 2 0 1 0 0 0 0 0 0
0 0 0 0 0 0 1 2 0 4 2 1 3 0 0 0 0 0 0 0
