0 0 0 0 0 0 0 0 0 0 0 0 0 0 0 0 0 0 0 0 0 0 0 0 0 0 0 1 0 0 0 0 0 1 0 0 0 0 0 0 0 0 0 0 0 0 0 0 0 0
0 0 0 0 0 0 0 0 0 0 0 0 0 0 0 0 0 0 0 0 0 0 1 0 0 0 0 0 0 0 0 0 0 0 0 0 0 0 0 0 0 0 0 0 0 0 0 0 0 0
0 0 0 0 0 0 0 0 0 0 0 0 0 0 0 0 0 0 0 0 0 0 0 0 0 0 0 0 0 0 1 0 0 0 0 0 0 0 0 0 0 0 0 0 0 0 0 0 0 0
0 0 0 0 0 0 0 0 0 0 0 0 0 0 0 0 0 0 0 0 0 1 0 0 0 0 0 0 0 0 0 0 0 0 0 0 0 0 0 0 0 0 0 0 0 0 0 0 0 0
0 0 0 0 0 0 0 0 0 0 0 0 0 0 0 0 0 0 0 0 0 0 0 0 0 0 2 1 0 0 1 0 0 0 0 0 1 0 0 0 0 0 0 0 0 0 0 0 0 0
0 0 0 0 0 0 0 0 0 0 0 0 0 0 0 0 0 0 0 0 0 0 0 0 1 1 0 0 1 0 0 0 0 0 0 0 0 0 0 0 0 0 0 0 0 0 0 0 0 0
0 0 0 0 0 0 0 0 0 0 0 0 0 0 0 0 0 0 0 1 1 0 0 1 2 0 1 0 1 1 0 0 0 0 1 0 0 0 0 0 0 0 0 0 0 0 0 0 0 0
0 0 0 0 0 0 0 0 0 0 0 0 0 0 0 0 0 0 1 0 0 0 1 1 0 1 3 1 0 1 3 0 0 3 2 0 1 0 0 0 0 0 0 0 0 0 0 0 0 0
0 0 0 0 0 0 0 0 0 0 0 0 0 0 0 0 0 1 0 0 2 0 5 0 1 1 1 1 2 0 1 2 1 1 0 0 0 0 0 0 0 0 0 0 0 0 0 0 0 0
0 0 0 0 0 0 0 0 0 1 0 0 0 0 0 0 0 2 1 0 4 1 0 0 1 2 0 2 3 4 2 0 1 1 0 0 0 0 0 0 0 0 0 0 0 0 0 0 0 0
0 0 0 0 0 0 0 0 0 0 0 0 0 1 0 0 0 1 1 2 0 2 5 1 2 2 1 4 6 3 4 1 1 2 3 3 1 1 0 0 0 0 0 0 0 0 0 0 0 0
0 0 0 0 0 0 0 0 0 0 0 1 0 1 1 1 0 2 4 3 1 5 1 4 3 4 6 6 4 6 2 4 5 3 1 1 2 0 2 0 0 0 0 0 0 0 0 0 0 0
0 0 0 0 0 0 0 0 0 1 0 0 0 0 0 0 2 1 1 4 4 2 0 2 0 8 6 4 5 3 7 6 6 6 4 2 2 2 2 1 0 0 1 0 1 1 0 0 0 0
0 0 0 0 0 0 0 0 0 0 0 0 1 0 0 0 0 0 3 4 2 4 3 4 7 7 11 9 10 11 9 10 7 4 4 2 6 2 5 0 0 0 1 1 0 0 0 0 0 0
0 0 0 0 0 0 0 0 0 0 0 1 0 2 0 0 3 2 1 6 3 4 5 4 6 9 11 13 15 4 16 9 7 10 7 8 6 1 2 3 1 1 0 1 0 0 0 0 0 0
0 0 0 0 0 0 0 1 0 0 0 1 1 1 0 2 1 3 2 2 8 8 4 9 8 16 10 10 19 17 14 14 7 16 16 9 3 7 2 1 2 0 0 0 1 1 0 0 0 0
0 0 0 0 0 0 0 0 0 0 0 0 1 1 3 2 3 1 8 4 8 6 6 14 5 8 16 17 18 17 16 19 10 14 6 6 5 6 1 2 0 0 0 1 0 0 1 0 0 0
0 0 0 0 0 0 0 0 0 2 1 1 0 4 1 2 1 4 9 8 7 8 14 8 12 10 5 21 24 9 16 24 13 9 9 7 9 5 3 0 1 1 1 0 0 0 0 0 0 0
0 0 0 0 0 0 0 0 0 1 0 1 2 1 2 5 3 4 4 4 14 10 12 13 10 12 27 20 18 17 14 15 16 13 14 11 10 4 3 1 1 0 1 1 0 0 0 0 0 0
0 0 0 0 0 0 1 1 0 0 1 0 2 1 2 2 2 6 7 8 10 10 7 9 19 10 14 13 16 17 15 17 13 9 10 6 8 4 2 2 0 0 1 1 0 0 0 0 0 0
0 0 0 0 0 0 0 0 0 1 1 1 4 4 0 2 3 9 6 8 9 12 17 15 12 15 24 13 20 26 23 13 14 12 8 8 3 1 2 2 0 2 0 0 0 0 0 0 0 0
1 0 0 0 0 0 0 0 0 1 2 1 2 2 1 6 6 8 11 13 10 19 13 14 28 22 13 13 18 14 19 13 7 6 8 4 6 4 0 0 0 0 0 0 0 1 0 0 0 0
0 1 0 0 0 0 0 2 0 1 0 1 0 3 4 7 11 6 12 13 17 7 13 17 15 17 19 21 21 18 16 14 11 10 3 6 2 5 4 2 3 0 0 0 0 1 0 0 0 0
0 0 0 0 0 0 0 1 2 1 1 0 3 4 2 8 12 9 12 10 12 17 18 19 16 10 14 17 21 12 18 18 6 6 9 6 1 2 1 0 1 0 0 0 0 0 0 0 0 0
0 0 0 0 0 0 0 1 0 0 3 4 4 3 2 4 8 4 8 20 19 19 15 14 20 13 13 20 15 13 10 9 12 9 4 3 2 3 0 1 2 0 0 0 0 0 0 0 0 1
0 0 0 1 0 0 0 0 0 1 0 0 0 4 4 2 8 11 6 19 12 12 24 16 9 14 16 15 10 18 12 5 8 6 6 2 2 6 2 0 3 3 0 0 0 0 0 0 0 0
0 0 0 0 0 1 0 0 1 0 0 3 3 5 1 7 7 12 11 13 19 12 18 13 19 16 17 15 9 13 11 8 13 3 5 8 3 4 2 0 1 1 0 1 0 0 0 0 0 0
0 0 0 0 0 0 0 0 0 1 1 1 1 2 4 5 5 11 11 12 20 11 16 18 13 10 17 11 12 14 10 13 6 6 6 3 2 2 1 0 1 2 0 1 1 0 0 0 0 0
0 0 0 0 0 0 0 0 0 0 0 0 1 1 6 4 6 6 12 20 18 17 12 10 14 10 13 8 16 9 11 8 10 10 4 4 4 4 3 1 0 0 0 0 1 0 0 0 0 0
0 0 0 0 0 0 0 1 1 2 0 1 1 0 1 3 4 5 10 20 17 17 16 11 6 15 11 17 9 6 10 8 7 6 4 2 1 0 3 2 0 0 0 0 0 0 0 0 0 0
0 0 0 0 0 0 1 0 0 0 0 1 1 0 3 5 8 13 8 17 11 12 9 8 13 10 6 13 10 7 3 6 6 4 1 2 0 2 0 1 2 0 0 1 1 0 0 0 0 0
0 0 0 0 0 0 0 0 0 1 1 0 0 2 2 2 3 4 9 9 8 13 10 11 8 3 7 9 5 7 8 1 5 3 8 1 2 0 1 1 1 0 1 0 0 0 0 0 0 0
0 0 0 0 0 0 0 0 0 0 1 0 1 1 1 4 5 7 7 10 12 7 10 9 11 5 6 8 7 9 2 5 4 4 0 2 3 1 0 2 0 0 0 0 0 0 0 0 0 0
0 0 0 0 0 0 0 0 1 0 0 0 0 1 2 3 2 6 8 11 6 12 6 5 8 9 5 2 5 2 7 1 2 2 1 2 1 0 1 0 0 0 1 0 0 0 0 0 0 0
0 0 0 0 0 0 0 0 0 0 0 1 0 0 1 3 2 2 8 4 12 5 4 4 6 5 2 0 2 5 1 0 0 0 3 0 1 0 1 0 1 0 0 0 0 0 0 0 0 0
0 0 0 0 0 0 0 0 0 0 0 0 0 1 0 3 5 9 2 7 5 2 7 2 6 1 3 1 1 0 1 0 0 0 2 2 2 1 0 0 1 0 0 0 0 0 0 0 0 0
0 0 0 0 0 0 0 0 0 0 0 0 1 0 0 2 5 6 7 11 6 10 3 4 2 0 3 2 0 2 1 0 0 1 0 0 0 0 0 1 0 0 0 0 0 0 0 0 0 0
0 0 0 0 0 0 0 0 0 0 0 0 0 0 1 2 2 0 9 4 4 5 6 1 3 5 1 1 0 1 1 0 0 0 0 0 1 0 0 0 0 0 0 0 0 0 0 0 0 0
0 0 0 0 0 0 0 0 0 0 0 0 1 1 1 1 2 3 2 4 2 5 3 0 1 1 0 1 0 1 0 0 0 0 0 0 0 0 0 0 0 0 0 0 0 0 0 0 0 0
0 0 0 0 0 0 0 0 0 0 0 0 0 0 0 0 1 2 1 1 1 1 1 1 0 0 0 1 0 0 0 1 0 0 0 0 0 0 0 0 0 0 0 0 0 0 0 0 0 0
0 0 0 0 0 0 0 0 0 0 0 0 0 0 1 0 1 2 1 1 3 1 0 1 0 0 1 0 0 0 0 0 0 0 0 0 0 0 0 0 0 0 0 0 0 0 0 0 0 0
0 0 0 0 0 0 0 0 0 0 0 0 0 0 0 0 0 0 1 3 1 0 1 1 2 0 1 0 0 0 0 0 0 0 0 0 0 0 0 0 0 0 0 0 0 0 0 0 0 0
0 0 0 0 0 0 0 0 0 0 0 0 0 0 0 0 0 0 0 1 0 0 0 0 1 0 1 0 0 0 0 0 0 0 0 0 0 0 0 0 0 0 0 0 0 0 0 0 0 0
0 0 0 0 0 0 0 0 0 0 0 0 0 0 0 0 0 0 1 2 0 1 0 0 0 0 0 0 0 0 0 0 0 0 0 0 0 0 0 0 0 0 0 0 0 0 0 0 0 0
0 0 0 0 0 0 0 0 0 0 0 0 0 0 0 0 0 0 0 0 1 1 0 0 0 0 0 0 0 0 0 0 0 0 0 0 0 0 0 0 0 0 0 0 0 0 0 0 0 0
0 0 0 0 0 0 0 0 0 0 0 0 0 0 0 0 0 0 1 0 0 0 0 0 0 0 0 0 0 0 0 0 0 0 0 0 0 0 0 0 0 0 0 0 0 0 0 0 0 0
0 0 0 0 0 0 0 0 0 0 0 0 0 0 0 1 0 0 0 0 1 0 0 0 0 0 0 0 0 0 0 0 0 0 0 0 0 0 0 0 0 0 0 0 0 0 0 0 0 0
0 0 0 0 0 0 0 0 0 0 0 0 0 0 0 0 0 0 0 1 0 0 0 0 0 0 0 0 0 0 0 0 0 0 0 0 0 0 0 0 0 0 0 0 0 0 0 0 0 0
0 0 0 0 0 0 0 0 0 0 0 0 0 0 0 0 0 1 0 1 0 0 0 0 0 0 0 0 0 0 0 0 0 0 0 0 0 0 0 0 0 0 0 0 0 0 0 0 0 0
0 0 0 0 0 0 0 0 0 0 0 0 0 0 0 0 0 0 1 0 0 0 0 0 0 0 0 0 0 0 0 0 0 0 0 0 0 0 0 0 0 0 0 0 0 0 0 0 0 0
