0 0 0 0 0 0 0 0 0 0 0 0 0 0 0 0 0 1 0 0 0 0 0 0 0 0 0 0 0 0 0 0 0 0 0 0 0 0 0 0
0 0 0 0 0 0 0 0 0 0 0 0 0 0 0 0 0 0 0 0 0 0 0 0 0 0 0 0 0 0 0 0 0 0 0 0 0 0 0 0
0 0 0 0 0 0 0 0 0 0 0 0 0 0 0 0 0 2 0 0 1 0 0 1 0 0 0 0 0 0 0 0 0 0 0 0 0 0 0 0
0 0 0 0 0 0 0 0 0 0 0 0 0 0 1 0 1 1 0 0 0 0 0 0 0 0 0 0 0 0 0 0 0 0 0 0 0 0 0 0
0 0 0 0 0 0 0 0 0 0 0 0 0 0 0 0 0 0 0 1 1 0 0 1 0 0 0 0 0 0 0 0 0 0 0 0 0 0 0 0
0 0 0 0 0 0 0 0 0 0 0 0 0 1 0 0 1 1 0 1 0 0 0 0 0 0 0 0 0 0 0 0 0 0 0 0 0 0 0 0
0 0 0 0 0 0 0 0 0 1 1 0 0 1 0 0 1 1 0 2 1 2 2 1 1 0 0 0 1 0 0 0 0 0 0 0 0 0 0 0
0 0 0 0 0 0 0 0 0 0 1 0 2 0 0 1 3 0 0 2 1 0 3 0 0 1 0 0 0 0 0 0 1 0 0 0 0 0 0 0
0 0 0 0 1 0 0 0 0 0 0 0 1 0 0 2 1 2 5 1 1 2 2 2 0 1 1 1 2 0 0 0 0 0 0 0 0 0 0 0
0 0 0 0 0 0 1 1 0 1 1 1 3 3 0 3 4 1 2 5 3 3 1 4 2 0 0 0 0 0 0 0 0 1 0 0 0 0 0 0
0 0 1 0 0 0 0 0 0 2 0 0 1 7 4 4 5 8 4 6 8 5 2 0 5 0 1 1 0 0 0 1 0 0 0 0 0 0 0 0
0 0 0 0 0 0 0 1 2 3 1 1 2 1 6 7 5 4 9 7 3 6 1 5 1 4 1 0 2 0 0 0 0 0 0 0 0 0 0 0
0 0 0 0 0 0 1 4 1 0 1 3 5 5 4 1 4 6 12 6 9 5 4 5 4 4 0 1 0 0 0 0 1 1 0 0 0 0 0 0
0 0 0 1 0 0 1 1 3 2 3 3 3 9 4 8 8 8 15 6 12 3 7 4 3 4 2 2 0 0 1 0 0 0 1 0 0 0 0 0
0 0 0 1 0 0 0 3 2 3 3 2 5 10 1 12 10 9 17 9 8 11 15 5 6 4 5 1 1 1 1 0 1 0 0 0 0 0 0 0
0 0 0 0 1 2 0 3 2 3 4 2 5 2 10 12 18 16 16 11 8 12 10 7 6 5 5 6 1 3 2 1 0 0 0 0 0 0 0 0
0 0 0 1 0 2 0 3 3 3 5 8 8 11 9 19 15 16 12 25 16 21 5 10 7 1 4 4 3 0 1 0 1 0 0 0 0 0 0 0
0 0 0 0 0 0 2 1 2 3 9 7 6 14 16 15 14 21 26 25 18 22 7 10 6 5 8 6 4 2 0 1 1 0 1 0 0 0 0 0
0 1 1 1 0 0 1 4 8 3 4 7 13 21 16 28 17 21 24 23 19 25 17 17 16 7 7 5 3 2 0 0 0 0 0 0 0 0 0 1
0 1 0 2 0 1 2 6 10 3 14 9 11 13 16 29 33 23 39 33 18 29 26 18 11 8 7 4 6 2 1 2 0 1 0 0 0 0 0 0
0 1 0 1 0 0 3 2 4 8 6 10 6 13 25 25 24 25 32 28 34 31 28 17 20 17 8 7 8 4 3 0 1 0 0 0 0 0 0 0
0 0 1 1 1 1 2 0 5 2 12 7 11 11 35 24 32 37 35 31 32 34 29 25 20 16 11 13 7 4 2 1 1 0 1 0 0 0 0 0
0 0 1 1 3 0 4 3 5 5 10 10 15 21 32 22 31 35 23 51 42 45 33 28 18 8 9 6 4 1 3 2 1 0 0 0 0 1 0 0
1 1 0 0 0 2 1 1 4 7 7 7 8 12 26 30 37 21 33 40 32 41 29 23 20 16 8 7 3 1 1 0 1 1 0 0 0 0 0 0
0 0 0 0 0 2 2 5 5 2 8 6 10 24 15 22 25 23 25 31 37 32 24 20 22 21 9 6 1 3 3 2 1 0 0 0 0 0 0 0
0 1 0 0 1 1 1 2 5 5 7 6 11 11 10 16 18 20 24 27 31 20 17 23 14 18 4 10 4 6 1 1 1 1 0 1 0 0 0 0
1 0 0 1 1 0 2 1 2 3 3 7 13 14 15 14 15 17 18 19 15 21 21 11 6 8 8 6 4 2 0 0 2 0 0 0 0 0 0 0
0 0 1 1 1 0 3 1 3 4 4 2 8 11 12 10 15 14 20 21 9 16 18 20 10 7 10 3 2 2 2 1 1 0 0 0 0 0 0 0
0 0 0 1 0 1 1 2 1 3 1 4 7 7 10 9 13 13 8 10 16 6 15 4 9 2 6 2 5 2 1 0 2 1 0 0 0 0 0 0
0 0 0 0 0 0 0 0 2 3 2 3 5 5 5 12 16 8 15 13 9 6 5 5 4 4 0 0 0 0 0 0 0 0 2 0 0 0 0 0
0 0 0 0 0 0 0 0 0 1 3 2 4 6 6 8 5 7 7 4 6 3 1 4 6 2 2 2 2 1 1 0 0 0 0 0 0 0 0 0
0 0 0 0 0 1 0 0 0 0 1 2 2 7 3 6 4 3 7 4 2 3 1 1 4 1 2 1 0 1 0 0 1 1 0 0 0 0 0 0
0 0 0 0 0 0 0 0 1 0 0 0 1 0 4 3 2 3 3 6 2 1 4 2 1 3 0 0 1 1 0 0 2 2 0 0 0 0 1 0
0 0 0 0 0 0 0 0 3 1 2 0 2 1 3 3 5 3 3 1 3 1 3 0 1 0 0 0 0 0 0 0 0 0 0 0 0 0 0 0
0 0 0 0 0 0 0 0 0 2 1 1 2 0 1 2 1 1 1 1 1 1 3 0 3 0 0 0 0 0 1 0 0 0 0 0 0 0 0 0
0 0 0 0 0 0 0 0 0 0 2 0 0 2 2 0 2 1 0 1 1 1 1 0 0 0 0 1 0 0 0 0 0 0 0 0 0 0 0 0
0 0 0 0 0 0 0 0 0 0 0 0 0 0 0 1 0 1 1 2 1 0 0 0 0 3 1 0 0 0 0 0 0 0 0 0 0 0 0 0
0 0 0 0 0 0 0 0 0 0 0 0 0 0 0 0 0 0 1 0 0 1 0 0 0 0 0 0 0 0 0 0 0 0 0 0 0 0 0 0
0 0 0 0 0 0 0 0 0 0 1 0 0 1 0 0 0 0 0 0 1 1 0 0 0 0 0 0 0 0 0 0 0 0 0 0 0 0 0 0
0 0 0 0 0 0 0 0 0 0 0 0 0 0 0 0 0 0 1 0 1 2 1 0 0 0 0 0 1 0 0 0 0 0 0 0 0 0 0 0
