0 0 0 0 0 0 0 0 0 0 0 0 0 0 0 0 0 0 0 0 0 0 0 1 1 0 0 0 0 0
0 0 0 0 0 0 0 0 0 0 0 0 0 0 0 0 0 0 0 0 0 0 0 0 0 0 0 0 0 0
0 0 0 0 0 0 0 0 0 0 0 0 0 0 0 0 0 0 0 0 0 0 0 1 0 0 0 0 0 0
0 0 0 0 0 0 0 0 0 0 0 0 0 0 0 0 0 0 0 0 0 0 1 0 0 0 0 0 0 0
0 0 0 0 0 0 0 0 0 0 0 1 0 0 2 2 0 0 0 2 0 0 1 1 1 1 1 0 0 0
0 0 0 0 0 0 0 0 1 1 0 0 0 0 3 3 3 3 3 5 1 1 1 0 1 0 0 0 0 0
0 0 0 0 0 0 0 0 1 0 1 0 5 1 6 7 11 6 6 4 1 4 2 1 1 1 1 0 0 1
0 0 0 0 0 0 0 0 0 0 1 1 2 5 9 23 15 14 7 8 4 6 5 1 2 2 0 0 0 0
0 0 0 0 0 0 0 2 3 2 1 3 3 5 17 24 29 20 19 7 3 6 7 9 4 3 1 0 0 0
0 0 0 0 0 0 2 2 1 2 1 6 4 11 28 29 40 30 32 13 13 7 15 5 6 4 0 3 0 0
0 0 0 0 0 1 0 6 3 7 7 5 6 5 22 47 44 34 31 18 11 8 6 14 13 7 2 0 0 1
0 0 0 0 3 2 1 8 2 15 7 9 16 18 12 30 40 36 23 15 12 11 10 9 6 6 3 1 0 0
1 0 0 1 0 5 6 15 8 17 13 12 14 16 12 25 28 24 14 18 13 16 11 5 10 4 4 1 1 1
0 0 0 0 1 3 7 13 12 21 26 24 18 10 14 17 13 19 15 11 12 14 11 14 13 4 5 1 1 0
0 0 0 1 3 5 9 16 14 26 26 33 17 20 19 14 9 10 9 12 10 17 20 8 4 7 7 3 0 1
0 0 0 2 5 2 13 20 22 26 24 26 31 25 19 13 7 10 11 11 9 7 17 12 6 3 1 0 1 0
0 0 0 0 1 1 12 10 16 16 34 27 20 29 26 16 15 17 11 19 8 10 17 11 3 5 1 2 0 0
0 0 0 2 2 3 7 11 17 21 22 35 44 51 30 17 23 9 10 12 8 11 9 5 8 4 1 0 0 0
0 0 0 1 4 2 11 11 22 26 29 33 44 50 43 36 30 25 19 9 9 9 11 8 0 4 2 1 0 2
0 0 1 1 4 3 6 4 10 27 39 38 46 32 43 46 30 32 19 12 15 8 8 2 3 1 2 1 0 0
0 0 0 0 1 1 5 5 7 27 27 33 45 47 35 38 27 29 21 18 11 6 4 3 2 0 0 0 0 0
0 0 0 0 1 6 5 2 14 19 22 41 38 33 37 30 37 26 15 16 13 5 5 2 2 0 0 0 0 0
0 0 0 0 0 0 2 4 8 14 16 26 29 27 22 26 25 14 15 11 8 6 4 2 1 1 0 0 0 0
0 0 0 0 1 3 3 5 6 7 14 20 21 12 16 9 15 9 5 9 2 3 1 0 2 1 0 1 0 0
0 0 0 0 1 2 1 1 3 11 12 9 16 10 9 8 3 2 7 0 1 1 0 0 0 0 0 0 0 0
0 0 0 0 0 0 3 3 6 2 4 8 6 8 3 2 1 1 1 2 0 1 0 0 0 0 0 0 0 0
0 0 0 0 0 1 0 0 1 4 2 6 3 0 1 2 1 0 0 0 0 0 0 0 0 0 0 0 0 0
0 0 0 0 0 0 0 1 2 1 4 3 2 0 0 0 0 0 0 0 0 0 0 0 0 0 0 0 0 0
0 0 0 0 0 0 0 0 0 1 0 1 2 0 0 1 0 0 0 0 0 0 0 0 0 0 0 0 0 0
0 0 0 0 0 0 0 0 0 2 2 0 0 0 0 0 0 0 0 0 0 0 0 0 0 0 0 0 0 0
