0 0 0 0 0 0 0 0 0 0 0 0 0 0 0 0 0 0 0 0 0 0 0 0 0 0 0 2 0 0 0 0 0 0 0 0 0 0 0 0 0 0 0 0 0 0 0 0 0 0 0 0 0 0 0 0 0 0 0 0
0 0 0 0 0 0 0 0 0 0 0 0 0 0 0 0 0 0 0 0 0 0 0 0 0 0 0 0 0 0 0 0 0 1 0 0 0 0 0 0 0 0 0 0 0 0 0 0 0 0 0 0 0 0 0 0 0 0 0 0
0 0 0 0 0 0 0 0 0 0 0 0 0 0 0 0 0 0 0 0 0 0 0 0 0 0 0 0 0 0 0 0 0 0 0 0 0 0 0 0 0 0 0 0 0 0 0 0 0 0 0 0 0 0 0 0 0 0 0 0
0 0 0 0 0 0 0 0 0 0 0 0 0 0 0 0 0 0 0 0 0 0 0 0 0 0 0 0 0 0 0 0 0 0 0 0 0 0 0 0 0 0 0 0 0 0 0 0 0 0 0 0 0 0 0 0 0 0 0 0
0 0 0 0 0 0 0 0 0 0 0 0 0 0 0 0 0 0 0 0 0 0 0 0 0 0 0 1 0 0 0 0 0 0 0 0 0 0 0 0 0 0 0 0 0 0 0 0 0 0 0 0 0 0 0 0 0 0 0 0
0 0 0 0 0 0 0 0 0 0 0 0 0 0 0 0 0 0 0 0 0 0 0 0 0 0 0 0 0 0 1 0 0 0 0 0 1 0 0 0 0 0 0 0 0 0 0 0 0 0 0 0 0 0 0 0 0 0 0 0
0 0 0 0 0 0 0 0 0 0 0 0 0 0 0 0 0 0 0 0 0 0 0 0 0 0 0 0 0 0 0 0 0 0 0 1 0 0 0 0 0 0 0 0 0 0 0 0 0 0 0 0 0 0 0 0 0 0 0 0
0 0 0 0 0 0 0 0 0 0 0 0 0 0 0 0 0 0 0 0 0 0 0 0 0 0 0 0 0 0 0 0 0 0 0 1 1 0 0 0 0 0 0 0 0 0 0 0 0 0 0 0 0 0 0 0 0 0 0 0
0 0 0 0 0 0 0 0 0 0 0 0 0 0 0 0 0 0 0 0 0 0 0 0 0 0 2 0 1 0 0 0 1 0 0 0 0 0 0 0 0 0 0 0 0 0 0 0 0 0 0 0 0 0 0 0 0 0 0 0
0 0 0 0 0 0 0 0 0 0 0 0 0 0 0 0 0 0 1 0 0 0 0 0 1 0 1 2 0 0 1 1 0 0 0 0 0 0 0 0 0 0 0 0 0 0 0 0 0 0 0 0 0 0 0 0 0 0 0 0
0 0 0 0 0 0 0 0 0 0 0 0 0 0 0 0 0 0 0 0 0 0 0 0 0 0 2 0 0 1 1 1 0 1 0 1 0 0 1 1 0 0 0 0 1 0 0 0 0 0 0 0 0 0 0 0 0 0 0 0
0 0 0 0 0 0 0 0 0 0 0 0 0 0 0 0 0 0 0 0 0 0 1 0 0 0 2 1 0 0 1 1 4 0 0 0 0 0 1 0 1 0 0 0 0 0 0 0 0 0 0 0 0 0 0 0 0 0 0 0
0 0 0 0 0 0 0 0 0 0 0 0 0 0 0 0 0 1 0 0 0 0 1 0 0 0 0 1 1 0 0 2 3 2 0 1 2 0 0 1 0 0 0 0 1 0 0 0 0 0 0 0 0 0 0 0 0 0 0 0
0 0 0 0 0 0 0 0 0 0 1 0 0 0 0 0 0 0 0 0 0 2 0 0 0 0 1 1 0 1 1 3 1 0 0 2 0 1 0 0 0 0 0 0 0 1 0 0 0 0 0 0 0 0 0 0 0 0 0 0
0 0 0 0 0 0 0 0 0 0 0 0 0 0 0 0 0 3 0 0 0 1 0 1 1 2 4 2 2 3 2 1 2 1 1 0 0 2 1 2 0 0 0 0 0 0 0 0 0 0 0 0 0 0 0 0 0 0 0 0
0 0 0 0 0 0 0 0 0 0 0 0 0 0 0 0 1 1 0 0 0 1 1 1 4 3 3 2 2 3 3 2 1 0 1 1 2 0 0 0 1 1 1 0 0 0 0 0 0 0 0 0 0 0 0 0 0 0 0 0
0 0 0 0 0 0 0 0 0 0 0 0 0 0 1 0 0 2 0 0 1 0 0 3 1 2 3 1 1 3 3 0 5 1 1 2 0 1 2 1 0 0 0 0 0 0 0 0 0 0 0 0 0 0 0 0 0 0 0 0
0 0 0 0 0 0 0 0 0 0 0 0 0 0 0 0 1 2 1 2 0 3 4 0 2 1 2 2 3 8 1 4 2 11 4 2 3 1 2 0 1 1 0 0 0 0 0 0 0 0 0 0 0 0 0 0 0 0 0 0
0 0 0 0 0 0 0 0 0 0 0 0 0 0 0 1 1 2 1 0 0 1 1 4 3 3 7 3 2 5 1 7 5 5 6 1 1 1 1 2 2 1 0 0 0 0 0 0 0 0 0 0 0 0 0 0 0 0 0 0
0 0 0 0 0 1 0 0 0 0 0 0 1 0 0 1 1 0 1 2 1 3 2 3 1 2 1 7 5 4 1 2 6 4 3 4 6 2 1 4 2 2 4 0 0 0 0 0 0 0 0 0 0 0 0 1 0 0 0 0
0 0 0 0 0 0 0 0 0 0 0 1 0 1 1 1 2 1 2 1 3 2 2 2 9 1 1 2 4 3 9 8 13 5 2 2 4 2 3 3 1 5 3 0 0 2 0 0 0 0 0 0 0 0 0 0 0 0 0 0
0 0 0 0 0 0 0 0 0 0 1 0 1 1 0 1 4 2 2 2 3 3 4 5 12 5 9 8 6 10 10 8 8 8 3 5 7 3 4 5 2 2 0 1 1 0 0 0 0 0 1 0 0 0 0 0 0 0 0 0
0 0 0 0 0 0 0 0 0 0 0 2 0 0 2 1 2 1 2 5 5 3 2 8 8 13 9 7 5 8 6 5 8 8 8 6 4 1 3 1 1 2 2 2 0 1 0 0 0 0 0 1 0 0 0 0 0 0 0 0
0 0 0 0 0 0 0 0 0 0 0 0 0 1 1 3 0 1 5 2 0 6 7 9 8 11 10 8 10 11 9 14 9 8 3 6 3 6 5 5 3 2 1 0 3 2 1 1 0 0 2 0 0 0 0 0 0 0 0 0
0 0 0 0 0 0 0 0 0 2 1 1 1 2 3 2 3 4 2 1 2 8 3 10 7 9 17 10 12 16 6 9 11 15 6 5 5 9 3 5 1 3 1 3 3 0 2 3 0 0 1 0 0 0 0 0 0 0 0 0
0 0 0 0 0 0 2 1 0 1 0 2 2 3 1 3 4 3 4 6 4 8 8 5 10 5 10 14 17 8 16 9 13 11 8 10 6 8 6 5 2 3 4 0 3 2 0 2 1 0 0 0 0 0 0 0 0 0 0 0
0 1 1 0 0 1 0 1 0 0 1 2 1 2 4 0 4 5 6 6 1 10 9 8 10 12 9 13 13 14 12 17 20 16 11 10 6 11 5 3 4 3 1 2 2 4 1 1 0 1 0 0 1 0 0 0 0 0 0 1
0 0 1 0 0 0 0 0 1 2 0 0 2 1 2 3 5 3 5 9 9 6 12 5 21 17 14 13 13 13 18 19 11 10 12 11 8 7 7 1 1 2 2 5 2 1 0 1 1 1 0 0 0 0 0 0 0 0 0 0
0 1 0 0 1 0 1 0 1 0 2 1 2 3 0 3 4 6 9 6 10 10 14 8 15 7 16 16 20 16 14 19 18 10 11 8 9 6 6 5 1 1 3 4 1 1 0 0 2 0 0 0 0 0 0 0 0 0 0 0
1 0 0 0 0 0 0 0 1 1 0 3 2 4 2 3 2 6 3 7 11 4 11 12 6 15 20 9 21 12 19 19 14 14 11 19 16 7 13 2 7 0 3 2 2 1 2 1 2 1 1 0 0 0 0 0 0 0 0 0
0 0 0 0 1 1 0 0 2 3 0 1 1 4 4 5 3 4 6 1 10 10 11 16 12 16 12 19 12 14 13 15 7 16 10 14 12 5 7 4 3 5 3 2 2 0 4 0 1 0 1 0 0 0 0 0 0 0 0 0
0 0 0 0 0 0 0 0 0 1 1 2 3 3 1 4 6 10 8 9 6 18 10 12 15 13 16 8 21 19 19 17 16 15 13 15 12 8 5 5 5 5 2 2 1 2 1 0 1 2 1 0 1 0 0 0 0 0 0 0
1 0 0 0 1 1 1 1 1 0 1 3 3 2 1 3 8 5 6 6 5 8 5 4 13 15 13 20 15 20 19 16 17 13 12 11 11 4 10 3 3 5 7 1 2 0 1 1 0 0 0 0 0 0 0 0 0 0 0 0
0 0 0 1 0 0 0 0 1 1 1 0 2 1 4 2 3 2 7 4 8 8 9 11 6 15 17 21 12 17 10 16 10 14 11 16 11 5 7 5 6 6 2 1 1 0 1 1 0 0 0 0 2 1 0 1 0 0 0 0
0 0 0 0 1 0 0 0 1 1 1 2 0 1 2 2 6 2 2 3 10 8 7 12 13 18 11 9 20 13 14 14 13 9 6 11 6 5 4 7 7 4 1 3 2 2 0 0 1 0 0 0 0 0 0 0 0 0 0 0
0 0 0 0 0 1 0 2 0 2 0 1 2 1 2 4 3 6 3 6 8 5 5 9 8 11 13 14 10 14 18 12 9 11 16 12 6 3 7 3 5 1 4 5 2 2 0 0 2 1 0 0 1 1 1 0 0 0 0 0
0 0 0 0 1 0 0 0 0 0 0 0 0 1 1 1 3 6 3 5 4 7 9 4 9 9 12 14 8 11 9 9 7 10 8 7 7 5 5 3 2 3 4 0 1 0 0 1 1 0 0 1 1 0 0 0 0 0 0 0
0 0 0 0 0 0 0 0 1 0 0 2 0 1 4 2 4 3 1 1 4 5 6 6 9 6 9 9 16 16 8 11 8 8 7 7 11 6 8 5 2 2 2 0 0 1 1 0 0 1 0 0 0 0 0 0 0 0 0 0
0 0 0 0 0 0 0 0 0 1 0 0 1 1 1 1 1 3 4 3 3 2 3 6 6 4 11 5 15 5 7 6 3 9 7 4 5 3 4 1 1 4 3 1 2 1 0 1 0 0 1 1 0 0 0 0 0 0 0 0
0 0 0 0 0 0 0 0 0 0 0 0 0 0 1 1 1 0 0 2 6 5 6 6 11 4 3 6 18 8 7 9 4 6 7 6 10 4 2 3 2 0 1 1 0 1 0 0 0 0 0 0 0 0 0 0 0 0 0 0
0 0 0 0 0 0 0 0 0 0 0 1 0 1 0 1 2 2 4 4 2 2 4 5 8 6 3 4 5 3 4 6 3 5 7 4 2 1 1 1 2 2 0 1 1 0 1 0 0 0 0 0 0 0 1 0 0 0 0 0
0 0 0 0 0 0 0 0 1 0 0 0 0 0 0 1 0 0 1 2 3 4 1 3 5 6 4 2 4 4 5 5 3 6 3 3 5 1 1 2 0 0 0 1 0 1 0 0 0 0 0 0 0 0 0 0 0 0 0 0
0 0 0 0 0 0 0 0 0 0 0 0 0 0 1 0 0 2 1 1 0 2 3 3 1 3 8 5 4 4 1 5 5 4 2 7 1 3 0 0 1 0 0 0 0 0 1 0 0 0 0 0 0 0 0 0 0 0 0 0
0 0 0 0 0 0 0 0 0 0 0 1 0 0 0 1 2 0 1 1 3 1 3 4 1 2 3 4 5 2 2 3 3 2 3 1 2 1 3 1 2 1 0 1 0 0 0 0 0 0 0 0 0 0 0 0 0 0 0 0
0 0 0 0 0 0 0 0 0 0 0 0 1 0 0 0 0 0 1 0 0 1 0 2 0 3 6 3 2 3 3 2 2 7 2 2 0 1 0 1 0 1 0 0 0 0 0 0 0 0 0 0 0 0 0 0 0 0 0 0
0 0 0 0 0 0 0 0 0 0 0 1 0 0 0 0 1 1 1 1 1 0 0 3 3 1 0 2 2 0 0 1 0 1 1 1 0 1 2 0 0 0 0 1 0 0 0 0 0 0 0 0 0 0 0 0 0 0 0 0
0 0 0 0 0 0 0 0 0 0 0 0 0 0 0 0 1 0 0 0 0 3 0 1 1 2 2 2 4 1 1 3 2 0 5 2 1 0 0 2 2 1 0 0 0 0 0 0 0 0 0 0 0 0 0 0 0 0 0 0
0 0 0 0 0 0 0 0 0 0 0 0 0 0 0 3 0 0 0 0 0 0 0 0 0 0 1 0 2 1 4 2 4 0 0 1 2 1 0 0 0 1 0 0 0 0 0 0 0 0 0 0 0 0 0 0 0 0 0 0
0 0 0 0 0 0 0 0 0 0 0 0 0 0 0 0 0 0 0 0 2 2 1 0 2 1 1 0 0 1 0 0 0 0 1 0 1 0 1 0 0 0 0 0 0 1 0 0 0 0 0 0 0 0 0 0 0 0 0 0
0 0 0 0 0 0 0 0 0 0 0 0 0 0 0 0 0 0 0 0 1 0 0 0 1 0 0 2 0 2 1 0 0 1 1 0 2 0 1 0 0 0 2 0 0 0 0 0 0 0 0 0 0 0 0 0 0 0 0 0
0 0 0 0 0 0 0 0 0 0 0 0 0 0 0 0 0 0 0 0 0 1 1 0 0 0 0 0 1 1 0 4 0 0 0 0 0 1 0 0 0 0 0 0 0 0 0 0 0 0 0 0 0 0 0 0 0 0 0 0
0 0 0 0 0 0 0 0 0 0 0 0 0 0 0 0 0 0 0 0 1 0 0 1 0 1 1 0 1 0 0 0 0 1 0 0 0 0 0 0 0 0 0 0 0 0 0 0 0 0 0 0 0 0 0 0 0 0 0 0
0 0 0 0 0 0 0 0 0 0 0 0 0 0 0 0 0 0 1 0 0 0 0 1 1 0 0 0 0 0 1 1 0 0 0 0 0 0 0 0 0 0 0 0 0 0 0 0 0 0 0 0 0 0 0 0 0 0 0 0
0 0 0 0 0 0 0 0 0 0 0 1 0 0 0 0 0 0 0 0 0 0 0 0 0 0 0 0 1 0 0 0 0 0 0 0 0 0 1 0 0 0 0 0 1 0 0 0 0 0 0 0 0 0 0 0 0 0 0 0
0 0 0 0 0 0 0 0 0 0 0 0 0 0 0 0 0 0 0 0 0 0 0 0 1 0 0 0 1 0 0 0 0 0 0 0 1 0 0 0 0 0 0 0 0 0 0 0 0 0 0 0 0 0 0 0 0 0 0 0
0 0 0 0 0 0 0 0 0 0 0 0 0 0 0 0 0 0 0 0 0 0 0 0 0 0 0 0 0 0 0 2 0 0 0 0 0 0 0 0 0 0 0 0 0 0 0 0 0 0 0 0 0 0 0 0 0 0 0 0
0 0 0 0 0 0 0 0 0 0 0 0 0 0 0 0 0 0 0 0 0 0 0 0 1 0 0 0 0 0 0 0 0 0 0 0 0 0 0 0 0 1 0 0 0 0 0 0 0 0 0 0 0 0 0 0 0 0 0 0
0 0 0 0 0 0 0 0 0 0 0 0 0 0 0 0 0 0 0 0 0 0 0 0 0 1 0 0 0 0 0 0 0 0 0 0 0 1 0 0 0 0 0 1 0 0 0 0 0 0 0 0 0 0 0 0 0 0 0 0
0 0 0 0 0 0 0 0 0 0 0 0 0 0 0 0 0 0 0 0 0 0 0 0 0 0 0 0 0 0 0 0 1 1 0 0 0 0 0 0 0 0 0 0 0 0 0 0 0 0 0 0 0 0 0 0 0 0 0 0
0 0 0 0 0 0 0 0 0 0 0 0 0 0 0 0 0 0 0 0 0 0 0 0 0 0 0 0 1 0 0 0 0 0 0 0 0 0 0 0 0 0 0 0 0 0 0 0 0 0 0 0 0 0 0 0 0 0 0 0
