0 1 2 2 1 0 1 0 0 0
0 1 4 5 12 10 6 1 0 0
1 8 30 54 61 27 11 7 0 0
5 22 75 217 282 164 52 21 5 0
7 55 250 669 809 351 113 39 9 1
5 32 157 458 448 213 83 20 7 0
4 6 56 128 143 76 35 6 2 0
1 0 11 30 38 15 6 1 1 0
0 0 3 8 6 3 3 1 0 0
0 1 0 0 2 0 0 0 0 0
